aaa	American Automobile Association, Inc.	generic	generic
aarp	AARP	generic	generic
abarth	Fiat Chrysler Automobiles N.V.	generic	generic
abb	ABB Ltd	generic	generic
abbott	Abbott Laboratories, Inc.	generic	generic
abbvie	AbbVie Inc.	generic	generic
abc	Disney Enterprises, Inc.	generic	generic
able	Able Inc.	generic	generic
abogado	Top Level Domain Holdings Limited	generic	generic
abudhabi	Abu Dhabi Systems and Information Centre	generic	generic
ac	Ascension Island	country-code	country-code
academy	Binky Moon, LLC	generic	generic
accenture	Accenture plc	generic	generic
accountant	dot Accountant Limited	generic	generic
accountants	Binky Moon, LLC	generic	generic
aco	ACO Severin Ahlmann GmbH & Co. KG	generic	generic
active	Active Network, LLC	generic	generic
actor	United TLD Holdco Ltd.	generic	generic
ad	Andorra (Principality of)	country-code	country-code
adac	Allgemeiner Deutscher Automobil-Club e.V. (ADAC)	generic	generic
ads	Charleston Road Registry Inc.	generic	generic
adult	ICM Registry AD LLC	generic	generic
ae	United Arab Emirates	country-code	country-code
aeg	Aktiebolaget Electrolux	generic	generic
aero	Air-transport industry	sponsored	sponsored
aetna	Aetna Life Insurance Company	generic	generic
af	Afghanistan (Islamic Republic of)	country-code	country-code
afamilycompany	Johnson Shareholdings, Inc.	generic	generic
afl	Australian Football League	generic	generic
africa	ZA Central Registry NPC trading as Registry.Africa	generic	generic
ag	Antigua and Barbuda	country-code	country-code
agakhan	Fondation Aga Khan (Aga Khan Foundation)	generic	generic
agency	Binky Moon, LLC	generic	generic
ai	Anguilla	country-code	country-code
aig	American International Group, Inc.	generic	generic
aigo	aigo Digital Technology Co,Ltd.	generic	generic
airbus	Airbus S.A.S.	generic	generic
airforce	United TLD Holdco Ltd.	generic	generic
airtel	Bharti Airtel Limited	generic	generic
akdn	Fondation Aga Khan (Aga Khan Foundation)	generic	generic
al	Albania (Republic of)	country-code	country-code
alfaromeo	Fiat Chrysler Automobiles N.V.	generic	generic
alibaba	Alibaba Group Holding Limited	generic	generic
alipay	Alibaba Group Holding Limited	generic	generic
allfinanz	Allfinanz Deutsche Vermögensberatung Aktiengesellschaft	generic	generic
allstate	Allstate Fire and Casualty Insurance Company	generic	generic
ally	Ally Financial Inc.	generic	generic
alsace	REGION GRAND EST	generic	generic
alstom	ALSTOM	generic	generic
am	Armenia (Republic of)	country-code	country-code
americanexpress	American Express Travel Related Services Company, Inc.	generic	generic
americanfamily	AmFam, Inc.	generic	generic
amex	American Express Travel Related Services Company, Inc.	generic	generic
amfam	AmFam, Inc.	generic	generic
amica	Amica Mutual Insurance Company	generic	generic
amsterdam	Gemeente Amsterdam	generic	generic
an	Netherlands Antilles	country-code	country-code
analytics	Campus IP LLC	generic	generic
android	Charleston Road Registry Inc.	generic	generic
anquan	QIHOO 360 TECHNOLOGY CO. LTD.	generic	generic
anz	Australia and New Zealand Banking Group Limited	generic	generic
ao	Angola (Republic of)	country-code	country-code
aol	OATH Inc.	generic	generic
apartments	Binky Moon, LLC	generic	generic
app	Charleston Road Registry Inc.	generic	generic
apple	Apple Inc.	generic	generic
aq	Antarctica	country-code	country-code
aquarelle	Aquarelle.com	generic	generic
ar	Argentina (Argentine Republic)	country-code	country-code
arab	League of Arab States	generic	generic
aramco	Aramco Services Company	generic	generic
archi	STARTING DOT LIMITED	generic	generic
army	United TLD Holdco Ltd.	generic	generic
arpa	Address and Routing Parameter Area	infrastructure	infrastructure
art	UK Creative Ideas Limited	generic	generic
arte	Association Relative à la Télévision Européenne G.E.I.E.	generic	generic
as	American Samoa	country-code	country-code
asda	Wal-Mart Stores, Inc.	generic	generic
asia	Organisations and individuals in the Asia-Pacific region	sponsored	sponsored
associates	Binky Moon, LLC	generic	generic
at	Austria (Republic of)	country-code	country-code
athleta	The Gap, Inc.	generic	generic
attorney	United TLD Holdco, Ltd	generic	generic
au	Australia (Commonwealth of)	country-code	country-code
auction	United TLD HoldCo, Ltd.	generic	generic
audi	AUDI Aktiengesellschaft	generic	generic
audible	Amazon Registry Services, Inc.	generic	generic
audio	Uniregistry, Corp.	generic	generic
auspost	Australian Postal Corporation	generic	generic
author	Amazon Registry Services, Inc.	generic	generic
auto	Cars Registry Limited	generic	generic
autos	DERAutos, LLC	generic	generic
avianca	Aerovias del Continente Americano S.A. Avianca	generic	generic
aw	Aruba	country-code	country-code
aws	Amazon Registry Services, Inc.	generic	generic
ax	Åland Islands	country-code	country-code
axa	AXA SA	generic	generic
az	Azerbaijan (Republic of)	country-code	country-code
azure	Microsoft Corporation	generic	generic
ba	Bosnia and Herzegovina	country-code	country-code
baby	Johnson & Johnson Services, Inc.	generic	generic
baidu	Baidu, Inc.	generic	generic
banamex	Citigroup Inc.	generic	generic
bananarepublic	The Gap, Inc.	generic	generic
band	United TLD Holdco, Ltd	generic	generic
bank	fTLD Registry Services, LLC	generic	generic
bar	Punto 2012 Sociedad Anonima Promotora de Inversion de Capital Variable	generic	generic
barcelona	Municipi de Barcelona	generic	generic
barclaycard	Barclays Bank PLC	generic	generic
barclays	Barclays Bank PLC	generic	generic
barefoot	Gallo Vineyards, Inc.	generic	generic
bargains	Binky Moon, LLC	generic	generic
baseball	MLB Advanced Media DH, LLC	generic	generic
basketball	Fédération Internationale de Basketball (FIBA)	generic	generic
bauhaus	Werkhaus GmbH	generic	generic
bayern	Bayern Connect GmbH	generic	generic
bb	Barbados	country-code	country-code
bbc	British Broadcasting Corporation	generic	generic
bbt	BB&T Corporation	generic	generic
bbva	BANCO BILBAO VIZCAYA ARGENTARIA, S.A.	generic	generic
bcg	The Boston Consulting Group, Inc.	generic	generic
bcn	Municipi de Barcelona	generic	generic
bd	Bangladesh (People's Republic of)	country-code	country-code
be	Belgium (Kingdom of)	country-code	country-code
beats	Beats Electronics, LLC	generic	generic
beauty	L'Oréal	generic	generic
beer	Top Level Domain Holdings Limited	generic	generic
bentley	Bentley Motors Limited	generic	generic
berlin	dotBERLIN GmbH & Co. KG	generic	generic
best	BestTLD Pty Ltd	generic	generic
bestbuy	BBY Solutions, Inc.	generic	generic
bet	Afilias plc	generic	generic
bf	Burkina Faso	country-code	country-code
bg	Bulgaria (Republic of)	country-code	country-code
bh	Bahrain (Kingdom of)	country-code	country-code
bharti	Bharti Enterprises (Holding) Private Limited	generic	generic
bi	Burundi (Republic of)	country-code	country-code
bible	American Bible Society	generic	generic
bid	dot Bid Limited	generic	generic
bike	Binky Moon, LLC	generic	generic
bing	Microsoft Corporation	generic	generic
bingo	Binky Moon, LLC	generic	generic
bio	STARTING DOT LIMITED	generic	generic
biz	Business	generic-restricted	generic-restricted
bj	Benin (Republic of)	country-code	country-code
bl	Saint Barthélemy (Collectivity of) {unassigned - see also: .gp and .fr}	country-code	country-code
black	Afilias plc	generic	generic
blackfriday	Uniregistry, Corp.	generic	generic
blanco	BLANCO GmbH + Co KG	generic	generic
blockbuster	Dish DBS Corporation	generic	generic
blog	Knock Knock WHOIS There, LLC	generic	generic
bloomberg	Bloomberg IP Holdings LLC	generic	generic
blue	Afilias plc	generic	generic
bm	Bermuda	country-code	country-code
bms	Bristol-Myers Squibb Company	generic	generic
bmw	Bayerische Motoren Werke Aktiengesellschaft	generic	generic
bn	Brunei (Nation of Brunei - the Abode of Peace) [Negara Brunei Darussalam]	country-code	country-code
bnl	Banca Nazionale del Lavoro	generic	generic
bnpparibas	BNP Paribas	generic	generic
bo	Bolivia (Plurinational State of)	country-code	country-code
boats	DERBoats, LLC	generic	generic
boehringer	Boehringer Ingelheim International GmbH	generic	generic
bofa	Bank of America Corporation	generic	generic
bom	Núcleo de Informação e Coordenação do Ponto BR - NIC.br	generic	generic
bond	Bond University Limited	generic	generic
boo	Charleston Road Registry Inc.	generic	generic
book	Amazon Registry Services, Inc.	generic	generic
booking	Booking.com B.V.	generic	generic
boots	Not assigned	generic	generic
bosch	Robert Bosch GMBH	generic	generic
bostik	Bostik SA	generic	generic
boston	Boston TLD Management, LLC	generic	generic
bot	Amazon Registry Services, Inc.	generic	generic
boutique	Binky Moon, LLC	generic	generic
box	NS1 Limited	generic	generic
bq	Caribbean Netherlands [Bonaire - Sint Eustatius and Saba] {unassigned - see also: .an and .nl}	country-code	country-code
br	Brazil (Federative Republic of)	country-code	country-code
bradesco	Banco Bradesco S.A.	generic	generic
bridgestone	Bridgestone Corporation	generic	generic
broadway	Celebrate Broadway, Inc.	generic	generic
broker	DOTBROKER REGISTRY LTD	generic	generic
brother	Brother Industries, Ltd.	generic	generic
brussels	DNS.be vzw	generic	generic
bs	Bahamas (Commonwealth of the)	country-code	country-code
bt	Bhutan (Kingdom of)	country-code	country-code
budapest	Top Level Domain Holdings Limited	generic	generic
bugatti	Bugatti International SA	generic	generic
build	Plan Bee LLC	generic	generic
builders	Binky Moon, LLC	generic	generic
business	Binky Moon, LLC	generic	generic
buy	Amazon Registry Services, INC	generic	generic
buzz	DOTSTRATEGY CO.	generic	generic
bv	Bouvet Island	country-code	country-code
bw	Botswana (Republic of)	country-code	country-code
by	Belarus (Republic of)	country-code	country-code
bz	Belize	country-code	country-code
bzh	Association www.bzh	generic	generic
ca	Canada	country-code	country-code
cab	Binky Moon, LLC	generic	generic
cafe	Binky Moon, LLC	generic	generic
cal	Charleston Road Registry Inc.	generic	generic
call	Amazon Registry Services, Inc.	generic	generic
calvinklein	PVH gTLD Holdings LLC	generic	generic
cam	AC Webconnecting Holding B.V.	generic	generic
camera	Binky Moon, LLC	generic	generic
camp	Binky Moon, LLC	generic	generic
cancerresearch	Australian Cancer Research Foundation	generic	generic
canon	Canon Inc.	generic	generic
capetown	ZA Central Registry NPC trading as ZA Central Registry	generic	generic
capital	Binky Moon, LLC	generic	generic
capitalone	Capital One Financial Corporation	generic	generic
car	Cars Registry Limited	generic	generic
caravan	Caravan International, Inc.	generic	generic
cards	Binky Moon, LLC	generic	generic
care	Binky Moon, LLC	generic	generic
career	dotCareer LLC	generic	generic
careers	Binky Moon, LLC	generic	generic
cars	Cars Registry Limited	generic	generic
cartier	Richemont DNS Inc.	generic	generic
casa	Top Level Domain Holdings Limited	generic	generic
case	CNH Industrial N.V.	generic	generic
caseih	CNH Industrial N.V.	generic	generic
cash	Binky Moon, LLC	generic	generic
casino	Binky Moon, LLC	generic	generic
cat	Catalan	sponsored	sponsored
catering	Binky Moon, LLC	generic	generic
catholic	Pontificium Consilium de Comunicationibus Socialibus (PCCS) (Pontifical Council for Social Communication)	generic	generic
cba	COMMONWEALTH BANK OF AUSTRALIA	generic	generic
cbn	The Christian Broadcasting Network, Inc.	generic	generic
cbre	CBRE, Inc.	generic	generic
cbs	CBS Domains Inc.	generic	generic
cc	Cocos (Keeling) Islands (Territory of the)	country-code	country-code
cd	Congo (Democratic Republic of the) [Congo-Kinshasa]	country-code	country-code
ceb	The Corporate Executive Board Company	generic	generic
center	Binky Moon, LLC	generic	generic
ceo	CEOTLD Pty Ltd	generic	generic
cern	"European Organization for Nuclear Research (""CERN"")"	generic	generic
cf	Central African Republic	country-code	country-code
cfa	CFA Institute	generic	generic
cfd	DOTCFD REGISTRY LTD	generic	generic
cg	Congo (Republic of) [Congo-Brazzaville]	country-code	country-code
ch	Switzerland (Swiss Confederation)	country-code	country-code
chanel	Chanel International B.V.	generic	generic
channel	Charleston Road Registry Inc.	generic	generic
charity	Corn Lake, LLC	generic	generic
chase	JPMorgan Chase Bank, National Association	generic	generic
chat	Binky Moon, LLC	generic	generic
cheap	Binky Moon, LLC	generic	generic
chintai	CHINTAI Corporation	generic	generic
chloe	Not assigned	generic	generic
christmas	Uniregistry, Corp.	generic	generic
chrome	Charleston Road Registry Inc.	generic	generic
chrysler	FCA US LLC.	generic	generic
church	Binky Moon, LLC	generic	generic
ci	Ivory Coast (Republic of Côte d'Ivoire)	country-code	country-code
cipriani	Hotel Cipriani Srl	generic	generic
circle	Amazon Registry Services, Inc.	generic	generic
cisco	Cisco Technology, Inc.	generic	generic
citadel	Citadel Domain LLC	generic	generic
citi	Citigroup Inc.	generic	generic
citic	CITIC Group Corporation	generic	generic
city	Binky Moon, LLC	generic	generic
cityeats	Lifestyle Domain Holdings, Inc.	generic	generic
ck	Cook Islands	country-code	country-code
cl	Chile (Republic of)	country-code	country-code
claims	Binky Moon, LLC	generic	generic
cleaning	Binky Moon, LLC	generic	generic
click	Uniregistry, Corp.	generic	generic
clinic	Binky Moon, LLC	generic	generic
clinique	The Estée Lauder Companies Inc.	generic	generic
clothing	Binky Moon, LLC	generic	generic
cloud	ARUBA PEC S.p.A.	generic	generic
club	.CLUB DOMAINS, LLC	generic	generic
clubmed	Club Méditerranée S.A.	generic	generic
cm	Cameroon (Republic of)	country-code	country-code
cn	China (People's Republic of)	country-code	country-code
co	Colombia (Republic of)	country-code	country-code
coach	Binky Moon, LLC	generic	generic
codes	Binky Moon, LLC	generic	generic
coffee	Binky Moon, LLC	generic	generic
college	XYZ.COM LLC	generic	generic
cologne	dotKoeln GmbH	generic	generic
com	Commercial organizations	generic	generic
comcast	Comcast IP Holdings I, LLC	generic	generic
commbank	COMMONWEALTH BANK OF AUSTRALIA	generic	generic
community	Binky Moon, LLC	generic	generic
company	Binky Moon, LLC	generic	generic
compare	iSelect Ltd	generic	generic
computer	Binky Moon, LLC	generic	generic
comsec	VeriSign, Inc.	generic	generic
condos	Binky Moon, LLC	generic	generic
construction	Binky Moon, LLC	generic	generic
consulting	United TLD Holdco, LTD.	generic	generic
contact	Top Level Spectrum, Inc.	generic	generic
contractors	Binky Moon, LLC	generic	generic
cooking	Top Level Domain Holdings Limited	generic	generic
cookingchannel	Lifestyle Domain Holdings, Inc.	generic	generic
cool	Binky Moon, LLC	generic	generic
coop	Cooperatives	sponsored	sponsored
corsica	Collectivité Territoriale de Corse	generic	generic
country	Top Level Domain Holdings Limited	generic	generic
coupon	Amazon Registry Services, Inc.	generic	generic
coupons	Binky Moon, LLC	generic	generic
courses	OPEN UNIVERSITIES AUSTRALIA PTY LTD	generic	generic
cr	Costa Rica (Republic of)	country-code	country-code
credit	Binky Moon, LLC	generic	generic
creditcard	Binky Moon, LLC	generic	generic
creditunion	CUNA Performance Resources, LLC	generic	generic
cricket	dot Cricket Limited	generic	generic
crown	Crown Equipment Corporation	generic	generic
crs	Federated Co-operatives Limited	generic	generic
cruise	Viking River Cruises (Bermuda) Ltd.	generic	generic
cruises	Binky Moon, LLC	generic	generic
csc	Alliance-One Services, Inc.	generic	generic
cu	Cuba (Republic of)	country-code	country-code
cuisinella	SALM S.A.S.	generic	generic
cv	Cape Verde (Republic of)	country-code	country-code
cw	Curaçao (Country of)	country-code	country-code
cx	Christmas Island (Territory of)	country-code	country-code
cy	Cyprus (Republic of)	country-code	country-code
cymru	Nominet UK	generic	generic
cyou	Beijing Gamease Age Digital Technology Co., Ltd.	generic	generic
cz	Czech Republic	country-code	country-code
dabur	Dabur India Limited	generic	generic
dad	Charleston Road Registry Inc.	generic	generic
dance	United TLD Holdco Ltd.	generic	generic
data	Dish DBS Corporation	generic	generic
date	dot Date Limited	generic	generic
dating	Binky Moon, LLC	generic	generic
datsun	NISSAN MOTOR CO., LTD.	generic	generic
day	Charleston Road Registry Inc.	generic	generic
dclk	Charleston Road Registry Inc.	generic	generic
dds	Minds + Machines Group Limited	generic	generic
de	Germany (Federal Republic of)	country-code	country-code
deal	Amazon Registry Services, Inc.	generic	generic
dealer	Dealer Dot Com, Inc.	generic	generic
deals	Binky Moon, LLC	generic	generic
degree	United TLD Holdco, Ltd	generic	generic
delivery	Binky Moon, LLC	generic	generic
dell	Dell Inc.	generic	generic
deloitte	Deloitte Touche Tohmatsu	generic	generic
delta	Delta Air Lines, Inc.	generic	generic
democrat	United TLD Holdco Ltd.	generic	generic
dental	Binky Moon, LLC	generic	generic
dentist	United TLD Holdco, Ltd	generic	generic
desi	Desi Networks LLC	generic	generic
design	Top Level Design, LLC	generic	generic
dev	Charleston Road Registry Inc.	generic	generic
dhl	Deutsche Post AG	generic	generic
diamonds	Binky Moon, LLC	generic	generic
diet	Uniregistry, Corp.	generic	generic
digital	Binky Moon, LLC	generic	generic
direct	Binky Moon, LLC	generic	generic
directory	Binky Moon, LLC	generic	generic
discount	Binky Moon, LLC	generic	generic
discover	Discover Financial Services	generic	generic
dish	Dish DBS Corporation	generic	generic
diy	Lifestyle Domain Holdings, Inc.	generic	generic
dj	Djibouti (Republic of)	country-code	country-code
dk	Denmark (Kingdom of)	country-code	country-code
dm	Dominica (Commonwealth of)	country-code	country-code
dnp	Dai Nippon Printing Co., Ltd.	generic	generic
do	Dominican Republic	country-code	country-code
docs	Charleston Road Registry Inc.	generic	generic
doctor	Binky Moon, LLC	generic	generic
dodge	FCA US LLC.	generic	generic
dog	Binky Moon, LLC	generic	generic
doha	Communications Regulatory Authority (CRA)	generic	generic
domains	Binky Moon, LLC	generic	generic
doosan	Retired	generic	generic
dot	Dish DBS Corporation	generic	generic
download	dot Support Limited	generic	generic
drive	Charleston Road Registry Inc.	generic	generic
dtv	Dish DBS Corporation	generic	generic
dubai	Dubai Smart Government Department	generic	generic
duck	Johnson Shareholdings, Inc.	generic	generic
dunlop	The Goodyear Tire & Rubber Company	generic	generic
duns	The Dun & Bradstreet Corporation	generic	generic
dupont	E. I. du Pont de Nemours and Company	generic	generic
durban	ZA Central Registry NPC trading as ZA Central Registry	generic	generic
dvag	Deutsche Vermögensberatung Aktiengesellschaft DVAG	generic	generic
dvr	Hughes Satellite Systems Corporation	generic	generic
dz	Algeria (People's Democratic Republic of)	country-code	country-code
earth	Interlink Co., Ltd.	generic	generic
eat	Charleston Road Registry Inc.	generic	generic
ec	Ecuador (Republic of)	country-code	country-code
eco	Big Room Inc.	generic	generic
edeka	EDEKA Verband kaufmännischer Genossenschaften e.V.	generic	generic
edu	Educational establishments	sponsored	sponsored
education	Binky Moon, LLC	generic	generic
ee	Estonia (Republic of)	country-code	country-code
eg	Egypt (Arab Republic of)	country-code	country-code
eh	Western Sahara {reserved}	country-code	country-code
email	Binky Moon, LLC	generic	generic
emerck	Merck KGaA	generic	generic
energy	Binky Moon, LLC	generic	generic
engineer	United TLD Holdco Ltd.	generic	generic
engineering	Binky Moon, LLC	generic	generic
enterprises	Binky Moon, LLC	generic	generic
epost	Deutsche Post AG	generic	generic
epson	Seiko Epson Corporation	generic	generic
equipment	Binky Moon, LLC	generic	generic
er	Eritrea (State of)	country-code	country-code
ericsson	Telefonaktiebolaget L M Ericsson	generic	generic
erni	ERNI Group Holding AG	generic	generic
es	Spain (Kingdom of)	country-code	country-code
esq	Charleston Road Registry Inc.	generic	generic
estate	Binky Moon, LLC	generic	generic
esurance	Esurance Insurance Company	generic	generic
et	Ethiopia (Federal Democratic Republic of)	country-code	country-code
etisalat	Emirates Telecommunications Corporation (trading as Etisalat)	generic	generic
eu	European Union	country-code	country-code
eurovision	European Broadcasting Union (EBU)	generic	generic
eus	Puntueus Fundazioa	generic	generic
events	Binky Moon, LLC	generic	generic
everbank	EverBank	generic	generic
exchange	Binky Moon, LLC	generic	generic
expert	Binky Moon, LLC	generic	generic
exposed	Binky Moon, LLC	generic	generic
express	Binky Moon, LLC	generic	generic
extraspace	Extra Space Storage LLC	generic	generic
fage	Fage International S.A.	generic	generic
fail	Binky Moon, LLC	generic	generic
fairwinds	FairWinds Partners, LLC	generic	generic
faith	dot Faith Limited	generic	generic
family	United TLD Holdco Ltd.	generic	generic
fan	Asiamix Digital Ltd	generic	generic
fans	Asiamix Digital Limited	generic	generic
farm	Binky Moon, LLC	generic	generic
farmers	Farmers Insurance Exchange	generic	generic
fashion	Top Level Domain Holdings Limited	generic	generic
fast	Amazon Registry Services, Inc.	generic	generic
fedex	Federal Express Corporation	generic	generic
feedback	Top Level Spectrum, Inc.	generic	generic
ferrari	Fiat Chrysler Automobiles N.V.	generic	generic
ferrero	Ferrero Trading Lux S.A.	generic	generic
fi	Finland (Republic of)	country-code	country-code
fiat	Fiat Chrysler Automobiles N.V.	generic	generic
fidelity	Fidelity Brokerage Services LLC	generic	generic
fido	Rogers Communications Canada Inc.	generic	generic
film	Motion Picture Domain Registry Pty Ltd	generic	generic
final	Núcleo de Informação e Coordenação do Ponto BR - NIC.br	generic	generic
finance	Binky Moon, LLC	generic	generic
financial	Binky Moon, LLC	generic	generic
fire	Amazon Registry Services, Inc.	generic	generic
firestone	Bridgestone Licensing Services, Inc.	generic	generic
firmdale	Firmdale Holdings Limited	generic	generic
fish	Binky Moon, LLC	generic	generic
fishing	Top Level Domain Holdings Limited	generic	generic
fit	Minds + Machines Group Limited	generic	generic
fitness	Binky Moon, LLC	generic	generic
fj	Fiji (Republic of)	country-code	country-code
fk	Falkland Islands (Malvinas)	country-code	country-code
flickr	Yahoo! Domain Services Inc.	generic	generic
flights	Binky Moon, LLC	generic	generic
flir	FLIR Systems, Inc.	generic	generic
florist	Binky Moon, LLC	generic	generic
flowers	Uniregistry, Corp.	generic	generic
flsmidth	Retired	generic	generic
fly	Charleston Road Registry Inc.	generic	generic
fm	Micronesia (Federated States of)	country-code	country-code
fo	Faroe Islands	country-code	country-code
foo	Charleston Road Registry Inc.	generic	generic
food	Lifestyle Domain Holdings, Inc.	generic	generic
foodnetwork	Lifestyle Domain Holdings, Inc.	generic	generic
football	Binky Moon, LLC	generic	generic
ford	Ford Motor Company	generic	generic
forex	DOTFOREX REGISTRY LTD	generic	generic
forsale	United TLD Holdco, LLC	generic	generic
forum	Fegistry, LLC	generic	generic
foundation	Binky Moon, LLC	generic	generic
fox	FOX Registry, LLC	generic	generic
fr	France (French Republic)	country-code	country-code
free	Amazon Registry Services, Inc.	generic	generic
fresenius	Fresenius Immobilien-Verwaltungs-GmbH	generic	generic
frl	FRLregistry B.V.	generic	generic
frogans	OP3FT	generic	generic
frontdoor	Lifestyle Domain Holdings, Inc.	generic	generic
frontier	Frontier Communications Corporation	generic	generic
ftr	Frontier Communications Corporation	generic	generic
fujitsu	Fujitsu Limited	generic	generic
fujixerox	Xerox DNHC LLC	generic	generic
fun	DotSpace, Inc.	generic	generic
fund	Binky Moon, LLC	generic	generic
furniture	Binky Moon, LLC	generic	generic
futbol	United TLD Holdco, Ltd.	generic	generic
fyi	Binky Moon, LLC	generic	generic
ga	Gabon (Gabonese Republic)	country-code	country-code
gal	Asociación puntoGAL	generic	generic
gallery	Binky Moon, LLC	generic	generic
gallo	Gallo Vineyards, Inc.	generic	generic
gallup	Gallup, Inc.	generic	generic
game	Uniregistry, Corp.	generic	generic
games	United TLD Holdco Ltd.	generic	generic
gap	The Gap, Inc.	generic	generic
garden	Top Level Domain Holdings Limited	generic	generic
gb	United Kingdom (United Kingdom of Great Britain and Northern Ireland)	country-code	country-code
gbiz	Charleston Road Registry Inc.	generic	generic
gd	Grenada	country-code	country-code
gdn	"Joint Stock Company ""Navigation-information systems"""	generic	generic
ge	Georgia	country-code	country-code
gea	GEA Group Aktiengesellschaft	generic	generic
gent	Combell nv	generic	generic
genting	Resorts World Inc. Pte. Ltd.	generic	generic
george	Wal-Mart Stores, Inc.	generic	generic
gf	French Guiana	country-code	country-code
gg	Guernsey (Bailiwick of)	country-code	country-code
ggee	GMO Internet, Inc.	generic	generic
gh	Ghana (Republic of)	country-code	country-code
gi	Gibraltar	country-code	country-code
gift	Uniregistry, Corp.	generic	generic
gifts	Binky Moon, LLC	generic	generic
gives	United TLD Holdco Ltd.	generic	generic
giving	Giving Limited	generic	generic
gl	Greenland	country-code	country-code
glade	Johnson Shareholdings, Inc.	generic	generic
glass	Binky Moon, LLC	generic	generic
gle	Charleston Road Registry Inc.	generic	generic
global	Dot Global Domain Registry Limited	generic	generic
globo	Globo Comunicação e Participações S.A	generic	generic
gm	Gambia (Republic of The)	country-code	country-code
gmail	Charleston Road Registry Inc.	generic	generic
gmbh	Binky Moon, LLC	generic	generic
gmo	GMO Internet, Inc.	generic	generic
gmx	1&1 Mail & Media GmbH	generic	generic
gn	Guinea (Republic of)	country-code	country-code
godaddy	Go Daddy East, LLC	generic	generic
gold	Binky Moon, LLC	generic	generic
goldpoint	YODOBASHI CAMERA CO.,LTD.	generic	generic
golf	Binky Moon, LLC	generic	generic
goo	NTT Resonant Inc.	generic	generic
goodhands	Allstate Fire and Casualty Insurance Company	generic	generic
goodyear	The Goodyear Tire & Rubber Company	generic	generic
goog	Charleston Road Registry Inc.	generic	generic
google	Charleston Road Registry Inc.	generic	generic
gop	Republican State Leadership Committee, Inc.	generic	generic
got	Amazon Registry Services, Inc.	generic	generic
gov	US government	sponsored	sponsored
gp	Guadeloupe	country-code	country-code
gq	Equatorial Guinea (Republic of)	country-code	country-code
gr	Greece (Hellenic Republic)	country-code	country-code
grainger	Grainger Registry Services, LLC	generic	generic
graphics	Binky Moon, LLC	generic	generic
gratis	Binky Moon, LLC	generic	generic
green	DotGreen Registry Limited	generic	generic
gripe	Binky Moon, LLC	generic	generic
grocery	Wal-Mart Stores, Inc.	generic	generic
group	Binky Moon, LLC	generic	generic
gs	South Georgia and the South Sandwich Islands	country-code	country-code
gt	Guatemala (Republic of)	country-code	country-code
gu	Guam	country-code	country-code
guardian	The Guardian Life Insurance Company of America	generic	generic
gucci	Guccio Gucci S.p.a.	generic	generic
guge	Charleston Road Registry Inc.	generic	generic
guide	Binky Moon, LLC	generic	generic
guitars	Uniregistry, Corp.	generic	generic
guru	Binky Moon, LLC	generic	generic
gw	Guinea-Bissau (Republic of)	country-code	country-code
gy	Guyana (Co-operative Republic of)	country-code	country-code
hair	L'Oreal	generic	generic
hamburg	Hamburg Top-Level-Domain GmbH	generic	generic
hangout	Charleston Road Registry Inc.	generic	generic
haus	United TLD Holdco, LTD.	generic	generic
hbo	HBO Registry Services, Inc.	generic	generic
hdfc	HOUSING DEVELOPMENT FINANCE CORPORATION LIMITED	generic	generic
hdfcbank	HDFC Bank Limited	generic	generic
health	DotHealth, LLC	generic	generic
healthcare	Binky Moon, LLC	generic	generic
help	Uniregistry, Corp.	generic	generic
helsinki	City of Helsinki	generic	generic
here	Charleston Road Registry Inc.	generic	generic
hermes	Hermes International	generic	generic
hgtv	Lifestyle Domain Holdings, Inc.	generic	generic
hiphop	Uniregistry, Corp.	generic	generic
hisamitsu	Hisamitsu Pharmaceutical Co.,Inc.	generic	generic
hitachi	Hitachi, Ltd.	generic	generic
hiv	Uniregistry, Corp.	generic	generic
hk	Hong Kong (Hong Kong Special Administrative Region of the People's Republic of China)	country-code	country-code
hkt	PCCW-HKT DataCom Services Limited	generic	generic
hm	Heard Island and McDonald Islands	country-code	country-code
hn	Honduras (Republic of)	country-code	country-code
hockey	Binky Moon, LLC	generic	generic
holdings	Binky Moon, LLC	generic	generic
holiday	Binky Moon, LLC	generic	generic
homedepot	Home Depot Product Authority, LLC	generic	generic
homegoods	The TJX Companies, Inc.	generic	generic
homes	DERHomes, LLC	generic	generic
homesense	The TJX Companies, Inc.	generic	generic
honda	Honda Motor Co., Ltd.	generic	generic
honeywell	Honeywell GTLD LLC	generic	generic
horse	Top Level Domain Holdings Limited	generic	generic
hospital	Binky Moon, LLC	generic	generic
host	DotHost Inc.	generic	generic
hosting	Uniregistry, Corp.	generic	generic
hot	Amazon Registry Services, Inc.	generic	generic
hoteles	Travel Reservations SRL	generic	generic
hotels	Booking.com B.V.	generic	generic
hotmail	Microsoft Corporation	generic	generic
house	Binky Moon, LLC	generic	generic
how	Charleston Road Registry Inc.	generic	generic
hr	Croatia (Republic of)	country-code	country-code
hsbc	HSBC Global Services (UK) Limited	generic	generic
ht	Haiti (Republic of)	country-code	country-code
htc	Not assigned	generic	generic
hu	Hungary	country-code	country-code
hughes	Hughes Satellite Systems Corporation	generic	generic
hyatt	Hyatt GTLD, L.L.C.	generic	generic
hyundai	Hyundai Motor Company	generic	generic
ibm	International Business Machines Corporation	generic	generic
icbc	Industrial and Commercial Bank of China Limited	generic	generic
ice	IntercontinentalExchange, Inc.	generic	generic
icu	Shortdot SA	generic	generic
id	Indonesia (Republic of)	country-code	country-code
ie	Ireland (Republic of)	country-code	country-code
ieee	IEEE Global LLC	generic	generic
ifm	ifm electronic gmbh	generic	generic
iinet	Retired	generic	generic
ikano	Ikano S.A.	generic	generic
il	Israel (State of)	country-code	country-code
im	Isle of Man	country-code	country-code
imamat	Fondation Aga Khan (Aga Khan Foundation)	generic	generic
imdb	Amazon Registry Services, Inc.	generic	generic
immo	Binky Moon, LLC	generic	generic
immobilien	United TLD Holdco Ltd.	generic	generic
in	India (Republic of)	country-code	country-code
industries	Binky Moon, LLC	generic	generic
infiniti	NISSAN MOTOR CO., LTD.	generic	generic
info	Informational sites	generic	generic
ing	Charleston Road Registry Inc.	generic	generic
ink	Top Level Design, LLC	generic	generic
institute	Binky Moon, LLC	generic	generic
insurance	fTLD Registry Services LLC	generic	generic
insure	Binky Moon, LLC	generic	generic
int	International treaty-based organizations	sponsored	sponsored
intel	Intel Corporation	generic	generic
international	Binky Moon, LLC	generic	generic
intuit	Intuit Administrative Services, Inc.	generic	generic
investments	Binky Moon, LLC	generic	generic
io	British Indian Ocean Territory	country-code	country-code
ipiranga	Ipiranga Produtos de Petroleo S.A.	generic	generic
iq	Iraq (Republic of)	country-code	country-code
ir	Iran (Islamic Republic of)	country-code	country-code
irish	Binky Moon, LLC	generic	generic
is	Iceland	country-code	country-code
iselect	iSelect Ltd	generic	generic
ismaili	Fondation Aga Khan (Aga Khan Foundation)	generic	generic
ist	Istanbul Metropolitan Municipality	generic	generic
istanbul	Istanbul Metropolitan Municipality	generic	generic
it	Italy (Italian Republic)	country-code	country-code
itau	Itau Unibanco Holding S.A.	generic	generic
itv	ITV Services Limited	generic	generic
iveco	CNH Industrial N.V.	generic	generic
iwc	Richemont DNS Inc.	generic	generic
jaguar	Jaguar Land Rover Ltd	generic	generic
java	Oracle Corporation	generic	generic
jcb	JCB Co., Ltd.	generic	generic
jcp	JCP Media, Inc.	generic	generic
je	Jersey (Bailiwick of)	country-code	country-code
jeep	FCA US LLC.	generic	generic
jetzt	Binky Moon, LLC	generic	generic
jewelry	Binky Moon, LLC	generic	generic
jio	Affinity Names, Inc.	generic	generic
jlc	Richemont DNS Inc.	generic	generic
jll	Jones Lang LaSalle Incorporated	generic	generic
jm	Jamaica (Commonwealth of)	country-code	country-code
jmp	Matrix IP LLC	generic	generic
jnj	Johnson & Johnson Services, Inc.	generic	generic
jo	Jordan (Hashemite Kingdom of)	country-code	country-code
jobs	Employment-related sites	sponsored	sponsored
joburg	ZA Central Registry NPC trading as ZA Central Registry	generic	generic
jot	Amazon Registry Services, Inc.	generic	generic
joy	Amazon Registry Services, Inc.	generic	generic
jp	Japan	country-code	country-code
jpmorgan	JPMorgan Chase Bank, National Association	generic	generic
jprs	Japan Registry Services Co., Ltd.	generic	generic
juegos	Uniregistry, Corp.	generic	generic
juniper	JUNIPER NETWORKS, INC.	generic	generic
kaufen	United TLD Holdco Ltd.	generic	generic
kddi	KDDI CORPORATION	generic	generic
ke	Kenya (Republic of)	country-code	country-code
kerryhotels	Kerry Trading Co. Limited	generic	generic
kerrylogistics	Kerry Trading Co. Limited	generic	generic
kerryproperties	Kerry Trading Co. Limited	generic	generic
kfh	Kuwait Finance House	generic	generic
kg	Kyrgyzstan (Kyrgyz Republic)	country-code	country-code
kh	Cambodia (Kingdom of)	country-code	country-code
ki	Kiribati (Republic of)	country-code	country-code
kia	KIA MOTORS CORPORATION	generic	generic
kim	Afilias plc	generic	generic
kinder	Ferrero Trading Lux S.A.	generic	generic
kindle	Amazon Registry Services, Inc.	generic	generic
kitchen	Binky Moon, LLC	generic	generic
kiwi	DOT KIWI LIMITED	generic	generic
km	Comoros (Union of the)	country-code	country-code
kn	Saint Kitts and Nevis (Federation of)	country-code	country-code
koeln	dotKoeln GmbH	generic	generic
komatsu	Komatsu Ltd.	generic	generic
kosher	Kosher Marketing Assets LLC	generic	generic
kp	Korea (Democratic People's Republic of) [North Korea]	country-code	country-code
kpmg	KPMG International Cooperative (KPMG International Genossenschaft)	generic	generic
kpn	Koninklijke KPN N.V.	generic	generic
kr	Korea (Republic of) [South Korea]	country-code	country-code
krd	KRG Department of Information Technology	generic	generic
kred	KredTLD Pty Ltd	generic	generic
kuokgroup	Kerry Trading Co. Limited	generic	generic
kw	Kuwait (State of Kuwait)	country-code	country-code
ky	Cayman Islands	country-code	country-code
kyoto	Academic Institution: Kyoto Jyoho Gakuen	generic	generic
kz	Kazakhstan (Republic of)	country-code	country-code
la	Laos (Lao People's Democratic Republic)	country-code	country-code
lacaixa	CAIXA D'ESTALVIS I PENSIONS DE BARCELONA	generic	generic
ladbrokes	LADBROKES INTERNATIONAL PLC	generic	generic
lamborghini	Automobili Lamborghini S.p.A.	generic	generic
lamer	The Estée Lauder Companies Inc.	generic	generic
lancaster	LANCASTER	generic	generic
lancia	Fiat Chrysler Automobiles N.V.	generic	generic
lancome	L'Oréal	generic	generic
land	Binky Moon, LLC	generic	generic
landrover	Jaguar Land Rover Ltd	generic	generic
lanxess	LANXESS Corporation	generic	generic
lasalle	Jones Lang LaSalle Incorporated	generic	generic
lat	ECOM-LAC Federación de Latinoamérica y el Caribe para Internet y el Comercio Electrónico	generic	generic
latino	Dish DBS Corporation	generic	generic
latrobe	La Trobe University	generic	generic
law	Minds + Machines Group Limited	generic	generic
lawyer	United TLD Holdco, Ltd	generic	generic
lb	Lebanon (Lebanese Republic)	country-code	country-code
lc	Saint Lucia	country-code	country-code
lds	IRI Domain Management, LLC	generic	generic
lease	Binky Moon, LLC	generic	generic
leclerc	A.C.D. LEC Association des Centres Distributeurs Edouard Leclerc	generic	generic
lefrak	LeFrak Organization, Inc.	generic	generic
legal	Binky Moon, LLC	generic	generic
lego	LEGO Juris A/S	generic	generic
lexus	TOYOTA MOTOR CORPORATION	generic	generic
lgbt	Afilias plc	generic	generic
li	Liechtenstein (Principality of)	country-code	country-code
liaison	Liaison Technologies, Incorporated	generic	generic
lidl	Schwarz Domains und Services GmbH & Co. KG	generic	generic
life	Binky Moon, LLC	generic	generic
lifeinsurance	American Council of Life Insurers	generic	generic
lifestyle	Lifestyle Domain Holdings, Inc.	generic	generic
lighting	Binky Moon, LLC	generic	generic
like	Amazon Registry Services, Inc.	generic	generic
lilly	Eli Lilly and Company	generic	generic
limited	Binky Moon, LLC	generic	generic
limo	Binky Moon, LLC	generic	generic
lincoln	Ford Motor Company	generic	generic
linde	Linde Aktiengesellschaft	generic	generic
link	Uniregistry, Corp.	generic	generic
lipsy	Lipsy Ltd	generic	generic
live	United TLD Holdco Ltd.	generic	generic
living	Lifestyle Domain Holdings, Inc.	generic	generic
lixil	LIXIL Group Corporation	generic	generic
lk	Sri Lanka (Democratic Socialist Republic of)	country-code	country-code
llc	Afilias plc	generic	generic
loan	dot Loan Limited	generic	generic
loans	Binky Moon, LLC	generic	generic
locker	Dish DBS Corporation	generic	generic
locus	Locus Analytics LLC	generic	generic
loft	Annco, Inc.	generic	generic
lol	Uniregistry, Corp.	generic	generic
london	Dot London Domains Limited	generic	generic
lotte	Lotte Holdings Co., Ltd.	generic	generic
lotto	Afilias plc	generic	generic
love	Merchant Law Group LLP	generic	generic
lpl	LPL Holdings, Inc.	generic	generic
lplfinancial	LPL Holdings, Inc.	generic	generic
lr	Liberia (Republic of)	country-code	country-code
ls	Lesotho (Kingdom of)	country-code	country-code
lt	Lithuania (Republic of)	country-code	country-code
ltd	Binky Moon, LLC	generic	generic
ltda	InterNetX Corp.	generic	generic
lu	Luxembourg (Grand Duchy of)	country-code	country-code
lundbeck	H. Lundbeck A/S	generic	generic
lupin	LUPIN LIMITED	generic	generic
luxe	Top Level Domain Holdings Limited	generic	generic
luxury	Luxury Partners LLC	generic	generic
lv	Latvia (Republic of)	country-code	country-code
ly	Libya	country-code	country-code
ma	Morocco	country-code	country-code
macys	Macys, Inc.	generic	generic
madrid	Comunidad de Madrid	generic	generic
maif	Mutuelle Assurance Instituteur France (MAIF)	generic	generic
maison	Binky Moon, LLC	generic	generic
makeup	L'Oréal	generic	generic
man	MAN SE	generic	generic
management	Binky Moon, LLC	generic	generic
mango	PUNTO FA S.L.	generic	generic
map	Charleston Road Registry Inc.	generic	generic
market	United TLD Holdco, Ltd	generic	generic
marketing	Binky Moon, LLC	generic	generic
markets	DOTMARKETS REGISTRY LTD	generic	generic
marriott	Marriott Worldwide Corporation	generic	generic
marshalls	The TJX Companies, Inc.	generic	generic
maserati	Fiat Chrysler Automobiles N.V.	generic	generic
mattel	Mattel Sites, Inc.	generic	generic
mba	Binky Moon, LLC	generic	generic
mc	Monaco (Principality of)	country-code	country-code
mcd	Not assigned	generic	generic
mcdonalds	Not assigned	generic	generic
mckinsey	McKinsey Holdings, Inc.	generic	generic
md	Moldova (Republic of)	country-code	country-code
me	Montenegro	country-code	country-code
med	Medistry LLC	generic	generic
media	Binky Moon, LLC	generic	generic
meet	Charleston Road Registry Inc.	generic	generic
melbourne	The Crown in right of the State of Victoria, represented by its Department of State Development, Business and Innovation	generic	generic
meme	Charleston Road Registry Inc.	generic	generic
memorial	Dog Beach, LLC	generic	generic
men	Exclusive Registry Limited	generic	generic
menu	Wedding TLD2, LLC	generic	generic
meo	Not assigned	generic	generic
merckmsd	MSD Registry Holdings, Inc.	generic	generic
metlife	MetLife Services and Solutions, LLC	generic	generic
mf	Saint Martin (Collectivity of) {unassigned - see also: .gp and .fr}	country-code	country-code
mg	Madagascar (Republic of)	country-code	country-code
mh	Marshall Islands (Republic of the)	country-code	country-code
miami	Top Level Domain Holdings Limited	generic	generic
microsoft	Microsoft Corporation	generic	generic
mil	US military	sponsored	sponsored
mini	Bayerische Motoren Werke Aktiengesellschaft	generic	generic
mint	Intuit Administrative Services, Inc.	generic	generic
mit	Massachusetts Institute of Technology	generic	generic
mitsubishi	Mitsubishi Corporation	generic	generic
mk	Macedonia (Republic of)	country-code	country-code
ml	Mali (Republic of)	country-code	country-code
mlb	MLB Advanced Media DH, LLC	generic	generic
mls	The Canadian Real Estate Association	generic	generic
mm	Myanmar (Republic of the Union of) [Burma]	country-code	country-code
mma	MMA IARD	generic	generic
mn	Mongolia	country-code	country-code
mo	Macau (Macau Special Administrative Region of the People's Republic of China) [Macao]	country-code	country-code
mobi	Mobile	generic	generic
mobile	Dish DBS Corporation	generic	generic
mobily	GreenTech Consultancy Company W.L.L.	generic	generic
moda	United TLD Holdco Ltd.	generic	generic
moe	Interlink Co., Ltd.	generic	generic
moi	Amazon Registry Services, Inc.	generic	generic
mom	Uniregistry, Corp.	generic	generic
monash	Monash University	generic	generic
money	Binky Moon, LLC	generic	generic
monster	Monster Worldwide, Inc.	generic	generic
montblanc	Not assigned	generic	generic
mopar	FCA US LLC.	generic	generic
mormon	"IRI Domain Management, LLC (""Applicant"")"	generic	generic
mortgage	United TLD Holdco, Ltd	generic	generic
moscow	Foundation for Assistance for Internet Technologies and Infrastructure Development (FAITID)	generic	generic
moto	Motorola Trademark Holdings, LLC	generic	generic
motorcycles	DERMotorcycles, LLC	generic	generic
mov	Charleston Road Registry Inc.	generic	generic
movie	Binky Moon, LLC	generic	generic
movistar	Telefónica S.A.	generic	generic
mp	Northern Mariana Islands (Commonwealth of the)	country-code	country-code
mq	Martinique	country-code	country-code
mr	Mauritania (Islamic Republic of)	country-code	country-code
ms	Montserrat	country-code	country-code
msd	MSD Registry Holdings, Inc.	generic	generic
mt	Malta (Republic of)	country-code	country-code
mtn	MTN Dubai Limited	generic	generic
mtpc	Retired	generic	generic
mtr	MTR Corporation Limited	generic	generic
mu	Mauritius (Republic of)	country-code	country-code
museum	Museums	sponsored	sponsored
mutual	Northwestern Mutual MU TLD Registry, LLC	generic	generic
mutuelle	Retired	generic	generic
mv	Maldives (Republic of)	country-code	country-code
mw	Malawi (Republic of)	country-code	country-code
mx	Mexico (United Mexican States)	country-code	country-code
my	Malaysia	country-code	country-code
mz	Mozambique (Republic of)	country-code	country-code
na	Namibia (Republic of)	country-code	country-code
nab	National Australia Bank Limited	generic	generic
nadex	Nadex Domains, Inc	generic	generic
nagoya	GMO Registry, Inc.	generic	generic
name	Individuals	generic-restricted	generic-restricted
nationwide	Nationwide Mutual Insurance Company	generic	generic
natura	NATURA COSMÉTICOS S.A.	generic	generic
navy	United TLD Holdco Ltd.	generic	generic
nba	NBA REGISTRY, LLC	generic	generic
nc	New Caledonia	country-code	country-code
ne	Niger (Republic of)	country-code	country-code
nec	NEC Corporation	generic	generic
net	Network	generic	generic
netbank	COMMONWEALTH BANK OF AUSTRALIA	generic	generic
netflix	Netflix, Inc.	generic	generic
network	Binky Moon, LLC	generic	generic
neustar	NeuStar, Inc.	generic	generic
new	Charleston Road Registry Inc.	generic	generic
newholland	CNH Industrial N.V.	generic	generic
news	United TLD Holdco Ltd.	generic	generic
next	Next plc	generic	generic
nextdirect	Next plc	generic	generic
nexus	Charleston Road Registry Inc.	generic	generic
nf	Norfolk Island (Territory of)	country-code	country-code
nfl	NFL Reg Ops LLC	generic	generic
ng	Nigeria (Federal Republic of)	country-code	country-code
ngo	Public Interest Registry	generic	generic
nhk	Japan Broadcasting Corporation (NHK)	generic	generic
ni	Nicaragua (Republic of)	country-code	country-code
nico	DWANGO Co., Ltd.	generic	generic
nike	NIKE, Inc.	generic	generic
nikon	NIKON CORPORATION	generic	generic
ninja	United TLD Holdco Ltd.	generic	generic
nissan	NISSAN MOTOR CO., LTD.	generic	generic
nissay	Nippon Life Insurance Company	generic	generic
nl	Netherlands	country-code	country-code
no	Norway (Kingdom of)	country-code	country-code
nokia	Nokia Corporation	generic	generic
northwesternmutual	Northwestern Mutual Registry, LLC	generic	generic
norton	Symantec Corporation	generic	generic
now	Amazon Registry Services, Inc.	generic	generic
nowruz	Asia Green IT System Bilgisayar San. ve Tic. Ltd. Sti.	generic	generic
nowtv	Starbucks (HK) Limited	generic	generic
np	Nepal (Federal Democratic Republic of)	country-code	country-code
nr	Nauru (Republic of)	country-code	country-code
nra	NRA Holdings Company, INC.	generic	generic
nrw	Minds + Machines GmbH	generic	generic
ntt	NIPPON TELEGRAPH AND TELEPHONE CORPORATION	generic	generic
nu	Niue	country-code	country-code
nyc	The City of New York by and through the New York City Department of Information Technology & Telecommunications	generic	generic
nz	New Zealand	country-code	country-code
obi	OBI Group Holding SE & Co. KGaA	generic	generic
observer	Top Level Spectrum, Inc.	generic	generic
off	Johnson Shareholdings, Inc.	generic	generic
office	Microsoft Corporation	generic	generic
okinawa	BRregistry, Inc.	generic	generic
olayan	Crescent Holding GmbH	generic	generic
olayangroup	Crescent Holding GmbH	generic	generic
oldnavy	The Gap, Inc.	generic	generic
ollo	Dish DBS Corporation	generic	generic
om	Oman (Sultanate of)	country-code	country-code
omega	The Swatch Group Ltd	generic	generic
one	One.com A/S	generic	generic
ong	Public Interest Registry	generic	generic
onl	I-REGISTRY Ltd., Niederlassung Deutschland	generic	generic
online	DotOnline Inc.	generic	generic
onyourside	Nationwide Mutual Insurance Company	generic	generic
ooo	INFIBEAM INCORPORATION LIMITED	generic	generic
open	American Express Travel Related Services Company, Inc.	generic	generic
oracle	Oracle Corporation	generic	generic
orange	Orange Brand Services Limited	generic	generic
org	Non-profit organizations	generic	generic
organic	Afilias plc	generic	generic
orientexpress	Retired	generic	generic
origins	The Estée Lauder Companies Inc.	generic	generic
osaka	Osaka Registry Co., Ltd.	generic	generic
otsuka	Otsuka Holdings Co., Ltd.	generic	generic
ott	Dish DBS Corporation	generic	generic
ovh	OVH SAS	generic	generic
pa	Panama (Republic of)	country-code	country-code
page	Charleston Road Registry Inc.	generic	generic
pamperedchef	Not assigned	generic	generic
panasonic	Panasonic Corporation	generic	generic
panerai	Richemont DNS Inc.	generic	generic
paris	City of Paris	generic	generic
pars	Asia Green IT System Bilgisayar San. ve Tic. Ltd. Sti.	generic	generic
partners	Binky Moon, LLC	generic	generic
parts	Binky Moon, LLC	generic	generic
party	Blue Sky Registry Limited	generic	generic
passagens	Travel Reservations SRL	generic	generic
pay	Amazon Registry Services, Inc.	generic	generic
pccw	PCCW Enterprises Limited	generic	generic
pe	Peru (Republic of)	country-code	country-code
pet	Afilias plc	generic	generic
pf	French Polynesia and Clipperton Island	country-code	country-code
pfizer	Pfizer Inc.	generic	generic
pg	Papua New Guinea (Independent State of)	country-code	country-code
ph	Philippines (Republic of the)	country-code	country-code
pharmacy	National Association of Boards of Pharmacy	generic	generic
phd	Charleston Road Registry Inc.	generic	generic
philips	Koninklijke Philips N.V.	generic	generic
phone	Dish DBS Corporation	generic	generic
photo	Uniregistry, Corp.	generic	generic
photography	Binky Moon, LLC	generic	generic
photos	Binky Moon, LLC	generic	generic
physio	PhysBiz Pty Ltd	generic	generic
piaget	Richemont DNS Inc.	generic	generic
pics	Uniregistry, Corp.	generic	generic
pictet	Pictet Europe S.A.	generic	generic
pictures	Binky Moon, LLC	generic	generic
pid	Top Level Spectrum, Inc.	generic	generic
pin	Amazon Registry Services, Inc.	generic	generic
ping	Ping Registry Provider, Inc.	generic	generic
pink	Afilias plc	generic	generic
pioneer	Pioneer Corporation	generic	generic
pizza	Binky Moon, LLC	generic	generic
pk	Pakistan (Islamic Republic of)	country-code	country-code
pl	Poland (Republic of)	country-code	country-code
place	Binky Moon, LLC	generic	generic
play	Charleston Road Registry Inc.	generic	generic
playstation	Sony Computer Entertainment Inc.	generic	generic
plumbing	Binky Moon, LLC	generic	generic
plus	Binky Moon, LLC	generic	generic
pm	Saint Pierre and Miquelon	country-code	country-code
pn	Pitcairn Islands (Pitcairn - Henderson - Ducie and Oeno Islands)	country-code	country-code
pnc	PNC Domain Co., LLC	generic	generic
pohl	Deutsche Vermögensberatung Aktiengesellschaft DVAG	generic	generic
poker	Afilias plc	generic	generic
politie	Politie Nederland	generic	generic
porn	ICM Registry PN LLC	generic	generic
post	Universal Postal Union	sponsored	sponsored
pr	Puerto Rico (Commonwealth of)	country-code	country-code
pramerica	Prudential Financial, Inc.	generic	generic
praxi	Praxi S.p.A.	generic	generic
press	DotPress Inc.	generic	generic
prime	Amazon Registry Services, Inc.	generic	generic
pro	Profession	generic-restricted	generic-restricted
prod	Charleston Road Registry Inc.	generic	generic
productions	Binky Moon, LLC	generic	generic
prof	Charleston Road Registry Inc.	generic	generic
progressive	Progressive Casualty Insurance Company	generic	generic
promo	Afilias plc	generic	generic
properties	Binky Moon, LLC	generic	generic
property	Uniregistry, Corp.	generic	generic
protection	XYZ.COM LLC	generic	generic
pru	Prudential Financial, Inc.	generic	generic
prudential	Prudential Financial, Inc.	generic	generic
ps	Palestine (State of)	country-code	country-code
pt	Portugal (Portuguese Republic)	country-code	country-code
pub	United TLD Holdco Ltd.	generic	generic
pw	Palau (Republic of)	country-code	country-code
pwc	PricewaterhouseCoopers LLP	generic	generic
py	Paraguay (Republic of)	country-code	country-code
qa	Qatar (State of)	country-code	country-code
qpon	dotCOOL, Inc.	generic	generic
quebec	PointQuébec Inc	generic	generic
quest	Quest ION Limited	generic	generic
qvc	QVC, Inc.	generic	generic
racing	Premier Registry Limited	generic	generic
radio	European Broadcasting Union (EBU)	generic	generic
raid	Johnson Shareholdings, Inc.	generic	generic
re	Réunion	country-code	country-code
read	Amazon Registry Services, Inc.	generic	generic
realestate	dotRealEstate LLC	generic	generic
realtor	Real Estate Domains LLC	generic	generic
realty	Fegistry, LLC	generic	generic
recipes	Binky Moon, LLC	generic	generic
red	Afilias plc	generic	generic
redstone	Redstone Haute Couture Co., Ltd.	generic	generic
redumbrella	Travelers TLD, LLC	generic	generic
rehab	United TLD Holdco Ltd.	generic	generic
reise	Binky Moon, LLC	generic	generic
reisen	Binky Moon, LLC	generic	generic
reit	National Association of Real Estate Investment Trusts, Inc.	generic	generic
reliance	Reliance Industries Limited	generic	generic
ren	Beijing Qianxiang Wangjing Technology Development Co., Ltd.	generic	generic
rent	XYZ.COM LLC	generic	generic
rentals	Binky Moon, LLC	generic	generic
repair	Binky Moon, LLC	generic	generic
report	Binky Moon, LLC	generic	generic
republican	United TLD Holdco Ltd.	generic	generic
rest	Punto 2012 Sociedad Anonima Promotora de Inversion de Capital Variable	generic	generic
restaurant	Binky Moon, LLC	generic	generic
review	dot Review Limited	generic	generic
reviews	United TLD Holdco, Ltd.	generic	generic
rexroth	Robert Bosch GMBH	generic	generic
rich	I-REGISTRY Ltd., Niederlassung Deutschland	generic	generic
richardli	Pacific Century Asset Management (HK) Limited	generic	generic
ricoh	Ricoh Company, Ltd.	generic	generic
rightathome	Johnson Shareholdings, Inc.	generic	generic
ril	Reliance Industries Limited	generic	generic
rio	Empresa Municipal de Informática SA - IPLANRIO	generic	generic
rip	United TLD Holdco Ltd.	generic	generic
rmit	Royal Melbourne Institute of Technology	generic	generic
ro	Romania	country-code	country-code
rocher	Ferrero Trading Lux S.A.	generic	generic
rocks	United TLD Holdco, LTD.	generic	generic
rodeo	Top Level Domain Holdings Limited	generic	generic
rogers	Rogers Communications Canada Inc.	generic	generic
room	Amazon Registry Services, Inc.	generic	generic
rs	Serbia (Republic of)	country-code	country-code
rsvp	Charleston Road Registry Inc.	generic	generic
ru	Russia (Russian Federation)	country-code	country-code
rugby	World Rugby Strategic Developments Limited	generic	generic
ruhr	regiodot GmbH & Co. KG	generic	generic
run	Binky Moon, LLC	generic	generic
rw	Rwanda (Republic of)	country-code	country-code
rwe	RWE AG	generic	generic
ryukyu	BRregistry, Inc.	generic	generic
sa	Saudi Arabia (Kingdom of)	country-code	country-code
saarland	dotSaarland GmbH	generic	generic
safe	Amazon Registry Services, Inc.	generic	generic
safety	Safety Registry Services, LLC.	generic	generic
sakura	SAKURA Internet Inc.	generic	generic
sale	United TLD Holdco, Ltd	generic	generic
salon	Binky Moon, LLC	generic	generic
samsclub	Wal-Mart Stores, Inc.	generic	generic
samsung	SAMSUNG SDS CO., LTD	generic	generic
sandvik	Sandvik AB	generic	generic
sandvikcoromant	Sandvik AB	generic	generic
sanofi	Sanofi	generic	generic
sap	SAP AG	generic	generic
sapo	Not assigned	generic	generic
sarl	Binky Moon, LLC	generic	generic
sas	Research IP LLC	generic	generic
save	Amazon Registry Services, Inc.	generic	generic
saxo	Saxo Bank A/S	generic	generic
sb	Solomon Islands	country-code	country-code
sbi	STATE BANK OF INDIA	generic	generic
sbs	SPECIAL BROADCASTING SERVICE CORPORATION	generic	generic
sc	Seychelles (Republic of)	country-code	country-code
sca	SVENSKA CELLULOSA AKTIEBOLAGET SCA (publ)	generic	generic
scb	"The Siam Commercial Bank Public Company Limited (""SCB"")"	generic	generic
schaeffler	Schaeffler Technologies AG & Co. KG	generic	generic
schmidt	SALM S.A.S.	generic	generic
scholarships	Scholarships.com, LLC	generic	generic
school	Binky Moon, LLC	generic	generic
schule	Binky Moon, LLC	generic	generic
schwarz	Schwarz Domains und Services GmbH & Co. KG	generic	generic
science	dot Science Limited	generic	generic
scjohnson	Johnson Shareholdings, Inc.	generic	generic
scor	SCOR SE	generic	generic
scot	Dot Scot Registry Limited	generic	generic
sd	Sudan (Republic of)	country-code	country-code
se	Sweden (Kingdom of)	country-code	country-code
search	Charleston Road Registry Inc.	generic	generic
seat	SEAT, S.A. (Sociedad Unipersonal)	generic	generic
secure	Amazon Registry Services, Inc.	generic	generic
security	XYZ.COM LLC	generic	generic
seek	Seek Limited	generic	generic
select	iSelect Ltd	generic	generic
sener	Sener Ingeniería y Sistemas, S.A.	generic	generic
services	Binky Moon, LLC	generic	generic
ses	SES	generic	generic
seven	Seven West Media Ltd	generic	generic
sew	SEW-EURODRIVE GmbH & Co KG	generic	generic
sex	ICM Registry SX LLC	generic	generic
sexy	Uniregistry, Corp.	generic	generic
sfr	Societe Francaise du Radiotelephone - SFR	generic	generic
sg	Singapore (Republic of)	country-code	country-code
sh	Saint Helena	country-code	country-code
shangrila	Shangri‐La International Hotel Management Limited	generic	generic
sharp	Sharp Corporation	generic	generic
shaw	Shaw Cablesystems G.P.	generic	generic
shell	Shell Information Technology International Inc	generic	generic
shia	Asia Green IT System Bilgisayar San. ve Tic. Ltd. Sti.	generic	generic
shiksha	Afilias plc	generic	generic
shoes	Binky Moon, LLC	generic	generic
shop	GMO Registry, Inc.	generic	generic
shopping	Binky Moon, LLC	generic	generic
shouji	QIHOO 360 TECHNOLOGY CO. LTD.	generic	generic
show	Binky Moon, LLC	generic	generic
showtime	CBS Domains Inc.	generic	generic
shriram	Shriram Capital Ltd.	generic	generic
si	Slovenia (Republic of)	country-code	country-code
silk	Amazon Registry Services, Inc.	generic	generic
sina	Sina Corporation	generic	generic
singles	Binky Moon, LLC	generic	generic
site	DotSite Inc.	generic	generic
sj	Svalbard and Jan Mayen {not in use - see also: .no}	country-code	country-code
sk	Slovakia (Slovak Republic)	country-code	country-code
ski	STARTING DOT LIMITED	generic	generic
skin	L'Oréal	generic	generic
sky	Sky International AG	generic	generic
skype	Microsoft Corporation	generic	generic
sl	Sierra Leone (Republic of)	country-code	country-code
sling	Hughes Satellite Systems Corporation	generic	generic
sm	San Marino (Republic of)	country-code	country-code
smart	Smart Communications, Inc. (SMART)	generic	generic
smile	Amazon Registry Services, Inc.	generic	generic
sn	Senegal (Republic of)	country-code	country-code
sncf	SNCF (Société Nationale des Chemins de fer Francais)	generic	generic
so	Somalia (Federal Republic of)	country-code	country-code
soccer	Binky Moon, LLC	generic	generic
social	United TLD Holdco Ltd.	generic	generic
softbank	SoftBank Group Corp.	generic	generic
software	United TLD Holdco, Ltd	generic	generic
sohu	Sohu.com Limited	generic	generic
solar	Binky Moon, LLC	generic	generic
solutions	Binky Moon, LLC	generic	generic
song	Amazon Registry Services, Inc.	generic	generic
sony	Sony Corporation	generic	generic
soy	Charleston Road Registry Inc.	generic	generic
space	DotSpace Inc.	generic	generic
spiegel	SPIEGEL-Verlag Rudolf Augstein GmbH & Co. KG	generic	generic
sport	Global Association of International Sports Federations (GAISF)	generic	generic
spot	Amazon Registry Services, Inc.	generic	generic
spreadbetting	DOTSPREADBETTING REGISTRY LTD	generic	generic
sr	Suriname (Republic of)	country-code	country-code
srl	InterNetX Corp.	generic	generic
srt	FCA US LLC.	generic	generic
ss	South Sudan (Republic of)	country-code	country-code
st	São Tomé and Príncipe (Democratic Republic of)	country-code	country-code
stada	STADA Arzneimittel AG	generic	generic
staples	Staples, Inc.	generic	generic
star	Star India Private Limited	generic	generic
starhub	StarHub Limited	generic	generic
statebank	STATE BANK OF INDIA	generic	generic
statefarm	State Farm Mutual Automobile Insurance Company	generic	generic
statoil	Statoil ASA	generic	generic
stc	Saudi Telecom Company	generic	generic
stcgroup	Saudi Telecom Company	generic	generic
stockholm	Stockholms kommun	generic	generic
storage	XYZ.COM LLC	generic	generic
store	DotStore Inc.	generic	generic
stream	dot Stream Limited	generic	generic
studio	United TLD Holdco Ltd.	generic	generic
study	OPEN UNIVERSITIES AUSTRALIA PTY LTD	generic	generic
style	Binky Moon, LLC	generic	generic
su	Soviet Union (Union of Soviet Socialist Republics)	country-code	country-code
sucks	Vox Populi Registry Ltd.	generic	generic
supplies	Binky Moon, LLC	generic	generic
supply	Binky Moon, LLC	generic	generic
support	Binky Moon, LLC	generic	generic
surf	Top Level Domain Holdings Limited	generic	generic
surgery	Binky Moon, LLC	generic	generic
suzuki	SUZUKI MOTOR CORPORATION	generic	generic
sv	El Salvador (Republic of)	country-code	country-code
swatch	The Swatch Group Ltd	generic	generic
swiftcover	Swiftcover Insurance Services Limited	generic	generic
swiss	Swiss Confederation	generic	generic
sx	Sint Maarten	country-code	country-code
sy	Syria (Syrian Arab Republic)	country-code	country-code
sydney	State of New South Wales, Department of Premier and Cabinet	generic	generic
symantec	Symantec Corporation	generic	generic
systems	Binky Moon, LLC	generic	generic
sz	Swaziland (Kingdom of)	country-code	country-code
tab	Tabcorp Holdings Limited	generic	generic
taipei	Taipei City Government	generic	generic
talk	Amazon Registry Services, Inc.	generic	generic
taobao	Alibaba Group Holding Limited	generic	generic
target	Target Domain Holdings, LLC	generic	generic
tatamotors	Tata Motors Ltd	generic	generic
tatar	"Limited Liability Company ""Coordination Center of Regional Domain of Tatarstan Republic"""	generic	generic
tattoo	Uniregistry, Corp.	generic	generic
tax	Binky Moon, LLC	generic	generic
taxi	Binky Moon, LLC	generic	generic
tc	Turks and Caicos Islands	country-code	country-code
tci	Asia Green IT System Bilgisayar San. ve Tic. Ltd. Sti.	generic	generic
td	Chad (Republic of)	country-code	country-code
tdk	TDK Corporation	generic	generic
team	Binky Moon, LLC	generic	generic
tech	Dot Tech LLC	generic	generic
technology	Binky Moon, LLC	generic	generic
tel	Telephone	sponsored	sponsored
telecity	TelecityGroup International Limited	generic	generic
telefonica	Telefónica S.A.	generic	generic
temasek	Temasek Holdings (Private) Limited	generic	generic
tennis	Binky Moon, LLC	generic	generic
teva	Teva Pharmaceutical Industries Limited	generic	generic
tf	French Southern and Antarctic Lands (Territory of the)	country-code	country-code
tg	Togo (Togolese Republic)	country-code	country-code
th	Thailand (Kingdom of)	country-code	country-code
thd	Home Depot Product Authority, LLC	generic	generic
theater	Binky Moon, LLC	generic	generic
theatre	XYZ.COM LLC	generic	generic
tiaa	Teachers Insurance and Annuity Association of America	generic	generic
tickets	Accent Media Limited	generic	generic
tienda	Binky Moon, LLC	generic	generic
tiffany	Tiffany and Company	generic	generic
tips	Binky Moon, LLC	generic	generic
tires	Binky Moon, LLC	generic	generic
tirol	punkt Tirol GmbH	generic	generic
tj	Tajikistan (Republic of)	country-code	country-code
tjmaxx	The TJX Companies, Inc.	generic	generic
tjx	The TJX Companies, Inc.	generic	generic
tk	Tokelau	country-code	country-code
tkmaxx	The TJX Companies, Inc.	generic	generic
tl	Timor-Leste (Democratic Republic of) [East Timor]	country-code	country-code
tm	Turkmenistan	country-code	country-code
tmall	Alibaba Group Holding Limited	generic	generic
tn	Tunisia (Republic of)	country-code	country-code
to	Tonga (Kingdom of)	country-code	country-code
today	Binky Moon, LLC	generic	generic
tokyo	GMO Registry, Inc.	generic	generic
tools	Binky Moon, LLC	generic	generic
top	Jiangsu Bangning Science & Technology Co.,Ltd.	generic	generic
toray	Toray Industries, Inc.	generic	generic
toshiba	TOSHIBA Corporation	generic	generic
total	Total SA	generic	generic
tours	Binky Moon, LLC	generic	generic
town	Binky Moon, LLC	generic	generic
toyota	TOYOTA MOTOR CORPORATION	generic	generic
toys	Binky Moon, LLC	generic	generic
tp	Timor-Leste (Democratic Republic of) [East Timor] {being phased out - also see: .tl}	country-code	country-code
tr	Turkey (Republic of)	country-code	country-code
trade	Elite Registry Limited	generic	generic
trading	DOTTRADING REGISTRY LTD	generic	generic
training	Binky Moon, LLC	generic	generic
travel	Travel	sponsored	sponsored
travelchannel	Lifestyle Domain Holdings, Inc.	generic	generic
travelers	Travelers TLD, LLC	generic	generic
travelersinsurance	Travelers TLD, LLC	generic	generic
trust	Artemis Internet Inc	generic	generic
trv	Travelers TLD, LLC	generic	generic
tt	Trinidad and Tobago (Republic of)	country-code	country-code
tube	Latin American Telecom LLC	generic	generic
tui	TUI AG	generic	generic
tunes	Amazon Registry Services, Inc.	generic	generic
tushu	Amazon Registry Services, Inc.	generic	generic
tv	Tuvalu	country-code	country-code
tvs	T V SUNDRAM IYENGAR  & SONS PRIVATE LIMITED	generic	generic
tw	Taiwan (Republic of China)	country-code	country-code
tz	Tanzania (United Republic of)	country-code	country-code
ua	Ukraine	country-code	country-code
ubank	National Australia Bank Limited	generic	generic
ubs	UBS AG	generic	generic
uconnect	FCA US LLC.	generic	generic
ug	Uganda (Republic of)	country-code	country-code
uk	United Kingdom (United Kingdom of Great Britain and Northern Ireland)	country-code	country-code
um	United States Minor Outlying Islands {formerly - retired 2010 - see also: .us}	country-code	country-code
unicom	China United Network Communications Corporation Limited	generic	generic
university	Binky Moon, LLC	generic	generic
uno	Dot Latin LLC	generic	generic
uol	UBN INTERNET LTDA.	generic	generic
ups	UPS Market Driver, Inc.	generic	generic
us	United States of America and United States Minor Outlying Islands	country-code	country-code
uy	Uruguay (Oriental Republic of)	country-code	country-code
uz	Uzbekistan (Republic of)	country-code	country-code
va	Vatican City (Vatican City State)	country-code	country-code
vacations	Binky Moon, LLC	generic	generic
vana	Lifestyle Domain Holdings, Inc.	generic	generic
vanguard	The Vanguard Group, Inc.	generic	generic
vc	Saint Vincent and the Grenadines	country-code	country-code
ve	Venezuela (Bolivarian Republic of)	country-code	country-code
vegas	Dot Vegas, Inc.	generic	generic
ventures	Binky Moon, LLC	generic	generic
verisign	VeriSign, Inc.	generic	generic
versicherung	TLD-BOX Registrydienstleistungen GmbH	generic	generic
vet	United TLD Holdco, Ltd	generic	generic
vg	British Virgin Islands (Virgin Islands)	country-code	country-code
vi	United States Virgin Islands (United States Virgin Islands)	country-code	country-code
viajes	Binky Moon, LLC	generic	generic
video	United TLD Holdco, Ltd	generic	generic
vig	VIENNA INSURANCE GROUP AG Wiener Versicherung Gruppe	generic	generic
viking	Viking River Cruises (Bermuda) Ltd.	generic	generic
villas	Binky Moon, LLC	generic	generic
vin	Binky Moon, LLC	generic	generic
vip	Minds + Machines Group Limited	generic	generic
virgin	Virgin Enterprises Limited	generic	generic
visa	Visa Worldwide Pte. Limited	generic	generic
vision	Binky Moon, LLC	generic	generic
vista	Vistaprint Limited	generic	generic
vistaprint	Vistaprint Limited	generic	generic
viva	Saudi Telecom Company	generic	generic
vivo	Telefonica Brasil S.A.	generic	generic
vlaanderen	DNS.be vzw	generic	generic
vn	Vietnam (Socialist Republic of)	country-code	country-code
vodka	Top Level Domain Holdings Limited	generic	generic
volkswagen	Volkswagen Group of America Inc.	generic	generic
volvo	Volvo Holding Sverige Aktiebolag	generic	generic
vote	Monolith Registry LLC	generic	generic
voting	Valuetainment Corp.	generic	generic
voto	Monolith Registry LLC	generic	generic
voyage	Binky Moon, LLC	generic	generic
vu	Vanuatu (Republic of)	country-code	country-code
vuelos	Travel Reservations SRL	generic	generic
wales	Nominet UK	generic	generic
walmart	Wal-Mart Stores, Inc.	generic	generic
walter	Sandvik AB	generic	generic
wang	Zodiac Wang Limited	generic	generic
wanggou	Amazon Registry Services, Inc.	generic	generic
warman	Weir Group IP Limited	generic	generic
watch	Binky Moon, LLC	generic	generic
watches	Richemont DNS Inc.	generic	generic
weather	International Business Machines Corporation	generic	generic
weatherchannel	International Business Machines Corporation	generic	generic
webcam	dot Webcam Limited	generic	generic
weber	Saint-Gobain Weber SA	generic	generic
website	DotWebsite Inc.	generic	generic
wed	Emergency Back-End Registry Operator Program - ICANN	generic	generic
wedding	Top Level Domain Holdings Limited	generic	generic
weibo	Sina Corporation	generic	generic
weir	Weir Group IP Limited	generic	generic
wf	Wallis and Futuna (Territory of the Wallis and Futuna Islands)	country-code	country-code
whoswho	Who's Who Registry	generic	generic
wien	punkt.wien GmbH	generic	generic
wiki	Top Level Design, LLC	generic	generic
williamhill	William Hill Organization Limited	generic	generic
win	First Registry Limited	generic	generic
windows	Microsoft Corporation	generic	generic
wine	Binky Moon, LLC	generic	generic
winners	The TJX Companies, Inc.	generic	generic
wme	William Morris Endeavor Entertainment, LLC	generic	generic
wolterskluwer	Wolters Kluwer N.V.	generic	generic
woodside	Woodside Petroleum Limited	generic	generic
work	Top Level Domain Holdings Limited	generic	generic
works	Binky Moon, LLC	generic	generic
world	Binky Moon, LLC	generic	generic
wow	Amazon Registry Services, Inc.	generic	generic
ws	Samoa (Independent State of)	country-code	country-code
wtc	World Trade Centers Association, Inc.	generic	generic
wtf	Binky Moon, LLC	generic	generic
xbox	Microsoft Corporation	generic	generic
xerox	Xerox DNHC LLC	generic	generic
xfinity	Comcast IP Holdings I, LLC	generic	generic
xihuan	QIHOO 360 TECHNOLOGY CO. LTD.	generic	generic
xin	Elegant Leader Limited	generic	generic
测试	Internet Assigned Numbers Authority	test	test
कॉम	VeriSign Sarl	generic	generic
परीक्षा	Internet Assigned Numbers Authority	test	test
セール	Amazon Registry Services, Inc.	generic	generic
佛山	Guangzhou YU Wei Information Technology Co., Ltd.	generic	generic
ಭಾರತ	National Internet eXchange of India	country-code	country-code
慈善	Excellent First Limited	generic	generic
集团	Eagle Horizon Limited	generic	generic
在线	TLD REGISTRY LIMITED	generic	generic
한국	KISA (Korea Internet & Security Agency)	country-code	country-code
ଭାରତ	National Internet eXchange of India	country-code	country-code
大众汽车	Volkswagen (China) Investment Co., Ltd.	generic	generic
点看	VeriSign Sarl	generic	generic
คอม	VeriSign Sarl	generic	generic
ভাৰত	National Internet eXchange of India	country-code	country-code
ভারত	National Internet Exchange of India	country-code	country-code
八卦	Zodiac Gemini Ltd	generic	generic
‏موقع‎	Suhub Electronic Establishment	generic	generic
বাংলা	Posts and Telecommunications Division	country-code	country-code
公益	China Organizational Name Administration Center	generic	generic
公司	Computer Network Information Center of Chinese Academy of Sciences （China Internet Network Information Center）	generic	generic
香格里拉	Shangri‐La International Hotel Management Limited	generic	generic
网站	Global Website TLD Asia Limited	generic	generic
移动	Afilias plc	generic	generic
我爱你	Tycoon Treasure Limited	generic	generic
москва	Foundation for Assistance for Internet Technologies and Infrastructure Development (FAITID)	generic	generic
испытание	Internet Assigned Numbers Authority	test	test
қаз	Association of IT Companies of Kazakhstan	country-code	country-code
католик	Pontificium Consilium de Comunicationibus Socialibus (PCCS) (Pontifical Council for Social Communication)	generic	generic
онлайн	CORE Association	generic	generic
сайт	CORE Association	generic	generic
联通	China United Network Communications Corporation Limited	generic	generic
срб	Serbian National Internet Domain Registry (RNIDS)	country-code	country-code
бг	Imena.BG AD	country-code	country-code
бел	Reliable Software, Ltd.	country-code	country-code
‏קום‎	VeriSign Sarl	generic	generic
时尚	RISE VICTORY LIMITED	generic	generic
微博	Sina Corporation	generic	generic
테스트	Internet Assigned Numbers Authority	test	test
淡马锡	Temasek Holdings (Private) Limited	generic	generic
ファッション	Amazon Registry Services, Inc.	generic	generic
орг	Public Interest Registry	generic	generic
नेट	VeriSign Sarl	generic	generic
ストア	Amazon Registry Services, Inc.	generic	generic
삼성	SAMSUNG SDS CO., LTD	generic	generic
சிங்கப்பூர்	Singapore Network Information Centre (SGNIC) Pte Ltd	country-code	country-code
商标	HU YI GLOBAL INFORMATION RESOURCES(HOLDING) COMPANY.HONGKONG LIMITED	generic	generic
商店	Binky Moon, LLC	generic	generic
商城	Zodiac Aquarius Limited	generic	generic
дети	The Foundation for Network Initiatives “The Smart Internet”	generic	generic
мкд	Macedonian Academic Research Network Skopje	country-code	country-code
‏טעסט‎	Internet Assigned Numbers Authority	test	test
ею	EURid vzw/asbl	country-code	country-code
ポイント	Amazon Registry Services, Inc.	generic	generic
新闻	Guangzhou YU Wei Information and Technology Co.,Ltd	generic	generic
工行	Industrial and Commercial Bank of China Limited	generic	generic
家電	Amazon Registry Services, Inc.	generic	generic
‏كوم‎	VeriSign Sarl	generic	generic
中文网	TLD REGISTRY LIMITED	generic	generic
中信	CITIC Group Corporation	generic	generic
中国	China Internet Network Information Center (CNNIC)	country-code	country-code
中國	China Internet Network Information Center (CNNIC)	country-code	country-code
娱乐	Binky Moon, LLC	generic	generic
谷歌	Charleston Road Registry Inc.	generic	generic
భారత్	National Internet Exchange of India	country-code	country-code
ලංකා	LK Domain Registry	country-code	country-code
電訊盈科	PCCW Enterprises Limited	generic	generic
购物	Minds + Machines Group Limited	generic	generic
測試	Internet Assigned Numbers Authority	test	test
クラウド	Amazon Registry Services, Inc.	generic	generic
ભારત	National Internet Exchange of India	country-code	country-code
通販	Amazon Registry Services, Inc.	generic	generic
भारतम्	National Internet eXchange of India	country-code	country-code
भारत	National Internet Exchange of India	country-code	country-code
भारोत	National Internet eXchange of India	country-code	country-code
‏آزمایشی‎	Internet Assigned Numbers Authority	test	test
பரிட்சை	Internet Assigned Numbers Authority	test	test
网店	Zodiac Taurus Ltd.	generic	generic
संगठन	Public Interest Registry	generic	generic
餐厅	HU YI GLOBAL INFORMATION RESOURCES (HOLDING) COMPANY. HONGKONG LIMITED	generic	generic
网络	Computer Network Information Center of Chinese Academy of Sciences （China Internet Network Information Center）	generic	generic
ком	VeriSign Sarl	generic	generic
укр	Ukrainian Network Information Centre (UANIC), Inc.	country-code	country-code
香港	Hong Kong Internet Registration Corporation Ltd.	country-code	country-code
诺基亚	Nokia Corporation	generic	generic
食品	Amazon Registry Services, Inc.	generic	generic
δοκιμή	Internet Assigned Numbers Authority	test	test
飞利浦	Koninklijke Philips N.V.	generic	generic
‏إختبار‎	Internet Assigned Numbers Authority	test	test
台湾	Taiwan Network Information Center (TWNIC)	country-code	country-code
台灣	Taiwan Network Information Center (TWNIC)	country-code	country-code
手表	Richemont DNS Inc.	generic	generic
手机	Beijing RITT-Net Technology Development Co., Ltd	generic	generic
мон	Datacom Co.,Ltd	country-code	country-code
‏الجزائر‎	CERIST	country-code	country-code
‏عمان‎	Telecommunications Regulatory Authority (TRA)	country-code	country-code
‏ارامكو‎	Aramco Services Company	generic	generic
‏ایران‎	Institute for Research in Fundamental Sciences (IPM)	country-code	country-code
‏العليان‎	Crescent Holding GmbH	generic	generic
‏اتصالات‎	Emirates Telecommunications Corporation (trading as Etisalat)	generic	generic
‏امارات‎	Telecommunications Regulatory Authority (TRA)	country-code	country-code
‏بازار‎	CORE Association	generic	generic
‏موريتانيا‎	Not assigned	country-code	country-code
‏پاکستان‎	National Telecommunication Corporation	country-code	country-code
‏الاردن‎	National Information Technology Center (NITC)	country-code	country-code
‏موبايلي‎	GreenTech Consultancy Company W.L.L.	generic	generic
‏بارت‎	National Internet eXchange of India	country-code	country-code
‏بھارت‎	National Internet Exchange of India	country-code	country-code
‏المغرب‎	Agence Nationale de Réglementation des Télécommunications (ANRT)	country-code	country-code
‏ابوظبي‎	Abu Dhabi Systems and Information Centre	generic	generic
‏السعودية‎	Communications and Information Technology Commission	country-code	country-code
‏ڀارت‎	National Internet eXchange of India	country-code	country-code
‏كاثوليك‎	Pontificium Consilium de Comunicationibus Socialibus (PCCS) (Pontifical Council for Social Communication)	generic	generic
‏سودان‎	Sudan Internet Society	country-code	country-code
‏همراه‎	Asia Green IT System Bilgisayar San. ve Tic. Ltd. Sti.	generic	generic
‏عراق‎	Communications and Media Commission (CMC)	country-code	country-code
‏مليسيا‎	MYNIC Berhad	country-code	country-code
澳門	Macao Post and Telecommunications Bureau (CTT)	country-code	country-code
닷컴	VeriSign Sarl	generic	generic
政府	Net-Chinese Co., Ltd.	generic	generic
‏شبكة‎	International Domain Registry Pty. Ltd.	generic	generic
‏بيتك‎	Kuwait Finance House	generic	generic
‏عرب‎	League of Arab States	generic	generic
გე	Information Technologies Development Center (ITDC)	country-code	country-code
机构	Public Interest Registry	generic	generic
组织机构	Public Interest Registry	generic	generic
健康	Stable Tone Limited	generic	generic
ไทย	Thai Network Information Center Foundation	country-code	country-code
‏سورية‎	National Agency for Network Services (NANS)	country-code	country-code
招聘	Dot Trademark TLD Holding Company Limited	generic	generic
рус	Rusnames Limited	generic	generic
рф	Coordination Center for TLD RU	country-code	country-code
珠宝	Richemont DNS Inc.	generic	generic
‏تونس‎	Agence Tunisienne d'Internet	country-code	country-code
大拿	VeriSign Sarl	generic	generic
みんな	Charleston Road Registry Inc.	generic	generic
グーグル	Charleston Road Registry Inc.	generic	generic
ελ	ICS-FORTH GR	country-code	country-code
世界	Stable Tone Limited	generic	generic
書籍	Amazon Registry Services, Inc.	generic	generic
ഭാരതം	National Internet eXchange of India	country-code	country-code
ਭਾਰਤ	National Internet Exchange of India	country-code	country-code
网址	KNET Co., Ltd	generic	generic
닷넷	VeriSign Sarl	generic	generic
コム	VeriSign Sarl	generic	generic
天主教	Pontificium Consilium de Comunicationibus Socialibus (PCCS) (Pontifical Council for Social Communication)	generic	generic
游戏	Binky Moon, LLC	generic	generic
vermögensberater	Deutsche Vermögensberatung Aktiengesellschaft DVAG	generic	generic
vermögensberatung	Deutsche Vermögensberatung Aktiengesellschaft DVAG	generic	generic
企业	Binky Moon, LLC	generic	generic
信息	Beijing Tele-info Network Technology Co., Ltd.	generic	generic
嘉里大酒店	Kerry Trading Co. Limited	generic	generic
嘉里	Kerry Trading Co. Limited	generic	generic
‏مصر‎	National Telecommunication Regulatory Authority - NTRA	country-code	country-code
‏قطر‎	Communications Regulatory Authority	country-code	country-code
广东	Guangzhou YU Wei Information Technology Co., Ltd.	generic	generic
இலங்கை	LK Domain Registry	country-code	country-code
இந்தியா	National Internet Exchange of India	country-code	country-code
հայ	"""Internet Society"" Non-governmental Organization"	country-code	country-code
新加坡	Singapore Network Information Centre (SGNIC) Pte Ltd	country-code	country-code
‏فلسطين‎	Ministry of Telecom & Information Technology (MTIT)	country-code	country-code
テスト	Internet Assigned Numbers Authority	test	test
政务	China Organizational Name Administration Center	generic	generic
xperia	Sony Mobile Communications AB	generic	generic
xxx	Adult entertainment	sponsored	sponsored
xyz	XYZ.COM LLC	generic	generic
yachts	DERYachts, LLC	generic	generic
yahoo	Yahoo! Domain Services Inc.	generic	generic
yamaxun	Amazon Registry Services, Inc.	generic	generic
yandex	YANDEX, LLC	generic	generic
ye	Yemen (Republic of)	country-code	country-code
yodobashi	YODOBASHI CAMERA CO.,LTD.	generic	generic
yoga	Top Level Domain Holdings Limited	generic	generic
yokohama	GMO Registry, Inc.	generic	generic
you	Amazon Registry Services, Inc.	generic	generic
youtube	Charleston Road Registry Inc.	generic	generic
yt	Mayotte (Department of)	country-code	country-code
yun	QIHOO 360 TECHNOLOGY CO. LTD.	generic	generic
za	South Africa (Republic of)	country-code	country-code
zappos	Amazon Registry Services, Inc.	generic	generic
zara	Industria de Diseño Textil, S.A. (INDITEX, S.A.)	generic	generic
zero	Amazon Registry Services, Inc.	generic	generic
zip	Charleston Road Registry Inc.	generic	generic
zippo	Zadco Company	generic	generic
zm	Zambia (Republic of)	country-code	country-code
zone	Binky Moon, LLC	generic	generic
zuerich	Kanton Zürich (Canton of Zurich)	generic	generic
zw	Zimbabwe (Republic of)	country-code	country-code
